...........
...........
...........
b.r.g.g.r.b
b.r.g.g.r.b
b.r.g.g.r.b
b.GoGoGoG.b
b.r.g.g.r.b
b.r.g.g.r.b
b.r.g.g.r.b
b.r.g.g.r.b
b.r.g.g.r.b
o.G.G.G.G.o
b.r.g.g.r.b


