...........
...........
...........
..GGGGGGG..
..grbGbrg..
..grbGbrg..
..grbGbrg..
..grbGbrg..
..grbGbrg..
..grbGbrg..
..grbGbrg..
..GGGGGGG..



