...........
...........
...........
...........
.oo.www.oo.
.ww.ooo.ww.
.bb.rrr.bb.
.pp.ggg.pp.
.gg.ppp.gg.
.rr.bbb.rr.
.oo.www.oo.
.ww.ooo.ww.

