...........
...........
...........
gGyGcGgGpGy
pGsGsGsGsGc
..p........
.G.GpG.G.G.
.G.G.GpG.G.
.G.G.G.GpG.
...........
.G.G.GpG.G.
.G.GpG.G.G.
..pG.G.G...
p....G.....



