.........w.
.........ww
...wwww....
....wwww...
.....GGG...
..w........
.wow.......
woGow......
.wow.......
..w.......o
..p..G.ggg.
g.p.g.g.gpg
Ggpg.pgGg..
Ggpg.g.ogg.
GGgGg..gg..

