...........
...........
...........
.G..G.G..G.
.GG.....GG.
.....o.....
....GgG....
..G..y..G..
.....b.....
..G..r..G..
....GgG....
.GG.....GG.
.G..G.G..G.


