...........
...........
b.r.g.p.b.r
s.s.s.s.s.s
.g.r.b.o.g.
.s.s.s.s.s.
o.b.r.g.p.b
s.s.s.s.s.s
.p.g.r.b.o.
.s.s.s.s.s.
g.o.b.r.g.p
s.s.s.s.s.s
.b.p.g.r.b.
.s.s.s.s.s.
r.g.o.b.r.g
s.s.s.s.s.s